제1과목

* DBMS
    - Web Application Server: 동적인 컨텐츠 처리하는 미들웨어
*관계
    - 연관관계: 실선
    - 집합 관계: 포함, part, 속이 빈 마름모
    - 포함 관계: 사물의 변화가 포함되는 사물에 영향을 미치는 집합 관계, 속 채워진 마름모
    - 의존 관계: 점선 화살표
    - 일반화: 속이 빈 화살표
    - 실체화: 기능으로 서로를 그룹화, 속이 빈 점선 화살표
*다이어그램
    - 구조적 다이어그램: 클래스, 객체, 컴포넌트, 배치, 복합체, 패키지
    - 행위 다이어그램: 유스케이스, 시퀀스, 커뮤니케이션, 상태, 활동, 상호작용 개요, 타이밍
* UI 설계 도구
    - 와이어프레임
    - 목업: 정적인 형태의 모형
    - 스토리보드: 최종적으로 참고
    - 프로토타입
    - 유스케이스
*소프트웨어 품질 요구사항 ISO/IEC 9126
    - 소프트웨어 품질 특성과 평가 위한 국제 표준
    - 기능성: 적합성, 적절성, 정밀성, 정확성, 상호운용성, 보안성, 준수성
    - 신뢰성: 성숙성, 고장 허용성, 회복성
    - 사용성: 이해성, 학습성, 운용성, 친밀성
    - 효율성: 시간 효율성, 자원 효율성
    - 유지보수성: 분석성, 변경성, 안정성, 시험성
    - 이식성: 적용성, 설치성, 대체성, 공존성
*객체
    -특성: 독립적으로 식별가능한 이름, 시간에 따라 변하는 상태, 상호 연관성에 의해 관계 형성, 객체가 반응할 수 있는 메시지의 집합은 행위, 일정한 기억장소 보유
*결합도: